NO ./path_to_the_north_texture
SO ./path_to_the_south_texture
EA ./path_to_the_east_texture
WE ./path_to_the_west_texture

F 220,000,4
C 25,33,22

111111111111111111111111
1000000000110000000000001
1011000001110000000000001
1001000000000000000000001
1111111110110000011100001
100000000011000001110111111111111
11110111111111011100000010001
11110111111111011101010010001
1100000011S101011100000010001              
10000000000000011000000100001
10000000000000001101010010001
1100000111010101111101111000111
11110111 110101 101111010001
11111111 1111111 111111111111