NO maps_textur/Brick-wall-texture-Graphics-7143465-1-580x387.xpm
SO maps_textur/images1.xpm
WE maps_textur/wiliiii.xpm


EA maps_textur/Red_brick_wall_texture.xpm

C 55,00,0
F 233,50,0







       1111111111111111111111111
       1000000000110000000000001
       10110000011100000N0000001
       1001000000000000000000001
111111111011000001110000000000001
10000000011111111111110111111111111
111101111   1111101110000111111
11110111111111111101010010001
11000000110101011100000010001
10000000000000001100000010001
10000000000000001101010010001
110000011101010111110111100111
11110111 1110101 101111010001
11111111 1111111 111111111111
