NO texturs/kmahdi.xpm
SO texturs/abel-bou.xpm
WE texturs/mchliyah.xpm
EA texturs/hsaidi.xpm

C 20,50,100
F 255,140,70

        1111111111111111111111111
        1000000000110000000000001
        101100S001110000000000001
        1001000000000000000000001
111111111011000001110000000000001
100000000011000001101111111111111
11110111111111011100000010001
11110111111111011101010010001
11000000110101011100000010001               
10000000000000001100000010001
10000000000000001101010010001
1100000111010101111101111000111
11110111 1110101 101111010001
11111111 1111111 11111111111





