NO texturs/AnyConv.com__barrel.xpm
SO texturs/AnyConv.com__colorstone.xpm
WE texturs/AnyConv.com__redbrick.xpm
EA texturs/AnyConv.com__wood.xpm

C 55,00,0
F 233,50,0

1111111111111111111111111
1000000000110000000000001
101100S001110000000000001
1001000000000000000000001
1111111111111111111111111
