EA texturs/AnyConv.com__wood.xpm

SO texturs/AnyConv.com__colorstone.xpm
NO texturs/AnyConv.com__barrel.xpm
WE texturs/AnyConv.com__redbrick.xpm

F 233,50,0



C 55,00,0

    1111111
    111E111
    11111111
    111101001
    1111111111

