NO texturs/AnyConv.com__barrel.xpm
SO texturs/AnyConv.com__colorstone.xpm
WE texturs/AnyConv.com__redbrick.xpm
EA texturs/AnyConv.com__wood.xpm

C 0,0,150
F 0,200,0

       1111111111111111111111111
       1000000000110000000000001
       1011000001110000010000001
       1001000000000000000000001
111111111011000001110000000000001
10000000011111111111110111111111111
111101111   111110111000011111111111111111111111111111111111111111111111
111101111111111111010100100000000000000000000000010000000000000000000001
110000001101010111000000100011111111111111110000010000000000000000000001
100000000000000011000000000000000000000000000000010000000000000000000001
100000000000000000010100000000000000000000000000000000000000000000000001
1111011111111111110101000000000000011000000000000S0000000000010000000001
1100000011010101110000001000000000011000000000000000000000000100000000001
100000000000000011000000000000000001100000000000000000000000010000000001
100000000000000000010100100000000000000000000000111111000000010000000001
111101111111111111010100100000000000000000000000000000000000010000000001
110000001101010111000000100000000000000000000000000000000000010000000001
10000000000000001100000000000000000000000000000000000000000000000000001
100000000000000000010000000000000000000011111111111000000000000000000001
111101111111111111010000000000000000000000000000000000000000000000000001
110000001101010111000000000000000000000000000000000000000000000000000001
100000000000000011000000001111111111111111110000000000000000000000000001
100000000000000000010000000000000000000000000000000000000000000000000001
11110111111111111101000000000000000000000000001000000000000000000000001
110000001101010111000000100000000000000000000010000000000000000000000001
100000000000000011000000100000000000000000000010000000000000000000000001
100000000000000000010000100000000000000000000010000000000000000000010001
11110111111111111101000000000000000000000000001000000000000000000001001
110000001101010111000000000000000000000000000010000000000000000000010001
100000000000000011000000000000000000000000000010000000000000000000010001
100000000000000000010000011111111110000000000000000000000000000000010001
111101111111111111010000000000000000000000000000000000000000000000010001
110000001101010111000000000000000000010000000000000000000000000000010001
10000000000000001100000000000000000001000000000000000000000000000000001
100000000000000000010000000000000000010000000000000000000000000000000001
111101111111111111010000000000000000010000000000000000000000000000000001
11000000110101011100000000000000000001000000000000000000000000000000001
10000000000000001100000000000000000001000000000000000000000000000000001
100000000000000000010100100000000000000000000000000000000000000000000001
110000011101010111110111100111111111111111111111111111111111111111111111
11110111 1110101 101111010001
11111111 1111111 11111111111





