NO texturs/AnyConv.com__barrel.xpm
SO texturs/AnyConv.com__colorstone.xpm
WE texturs/AnyConv.com__redbrick.xpm
EA texturs/AnyConv.com__wood.xpm

C 55,00,0
F 233,50,0

       1111111111111111111111111
       1000000000110000000000001
       1011000001110000010000001
       1001000000000000000000001
111111111011000001110000000000001
10000000011111111111110111111111111
111101111   1111101110000111111
11110111111111111101010010001
11000000110101011100000010001
10000000000000001100000010001
10000000000000000W01010010001
110000011101010111110111100111
11110111 1110101 101111010001
11111111 1111111 11111111111





