define
cjlhcl
dch§

    10110000011100000000000001
1001000000000000000000001
11111111011000001110000000000001
100000000011000001110111111111111
     1110111111111011100000010001
11110111111111011101010010001
11000000110101011100000010001
1000000000000001100000010001
1000000000000001101010010001
11000001110101011111011110N01
11110111 1110101 101111010001
11111111 111111 111111111111
