define
cjlhclefwfewfew
kjn
jhb
dch§


11111
11001
11001
11111
