11111111111111
1E000000000001
10010111100101
10010100100001
10011100100001
10000000111001
1001000000P001
11111111111111